5,2,2,2,2,2,2,2,6,3,2,2,2,2,2,2,2,2,2,6;
7,1,11,1,1,1,22,1,7,13,1,1,1,1,1,1,1,1,1,1,7;
7,13,7,13,13,13,7,13,7,13,13,13,13,13,13,13,13,13,13,13,7;
7,13,8,13,11,13,8,13,7,13,11,13,5,2,2,2,6,13,3,4,7;
7,13,1,13,7,13,1,13,7,13,7,13,7,1,1,1,7,13,1,1,7;
7,13,13,13,7,13,13,13,7,13,7,13,7,13,13,13,7,13,13,13,7;
7,3,4,13,7,3,7,7,10,13,7,13,7,13,11,13,7,3,4,13,7;
7,1,1,13,7,1,1,1,1,13,7,13,7,13,7,13,7,1,1,13,7;
7,13,13,13,8,13,13,13,13,13,9,4,7,13,7,13,7,13,13,13,7;
7,13,5,2,2,2,2,2,6,13,1,1,7,13,7,13,7,3,2,4,7;
7,13,8,1,1,1,1,1,7,13,13,13,7,13,7,13,7,1,1,1,7;
7,13,1,13,13,13,13,13,9,2,4,13,7,,13,7,13,7,13,13,13,7;
7,13,13,13,5,2,6,13,1,1,1,13,7,13,7,13,7,13,11,13,7;
7,13,5,7,10,1,7,13,13,13,13,13,7,13,7,13,7,13,7,13,7;
7,13,7,1,1,13,7,3,2,2,2,2,10,13,7,3,10,13,7,13,7;
7,13,8,13,13,13,8,1,1,1,1,1,1,13,7,1,1,13,7,13,7;
7,13,1,13,11,13,1,13,13,13,13,13,13,13,7,13,13,13,7,13,7;
7,13,13,13,8,13,13,13,5,2,6,13,3,4,7,13,5,2,10,13,7;
7,3,2,2,2,2,4,13,7,14,7,13,1,1,8,13,7,1,1,13,7;
7,1,1,1,1,1,1,13,7,13,7,13,13,13,1,13,7,13,13,13,7;
7,13,13,13,13,13,13,13,7,13,7,13,11,13,13,13,8,13,13,13,7;
7,13,5,2,2,2,4,13,7,13,7,3,10,3,2,2,2,2,6,13,7;
7,13,7,1,11,1,1,13,7,13,7,1,1,1,1,1,1,1,7,13,7;
7,13,7,13,7,13,13,13,7,13,7,13,13,13,13,13,13,13,7,13,7;
7,13,8,13,7,13,3,2,10,13,7,13,5,2,4,13,11,13,8,13,7;
7,13,1,13,7,13,1,1,1,13,7,13,7,1,1,13,7,13,1,13,7;
7,13,13,13,8,13,13,13,13,13,7,13,7,13,13,13,8,13,13,13,7;
9,2,2,2,2,2,2,2,2,2,10,13,9,2,2,2,2,2,2,2,10;